11111111111111111111111111111
14000000000000000000000000041
10110111101111011110111011101
10100000001000000010001010001
10101111101011111011101010101
10000001000000100000000010101
10111101011110101111011000101
10100000010000000000011011101
10101111010111211101000000001
101010000001g333g101011010101
101010110101g333g100000010101
10000000010111111101011110101
10111011000000000001000000101
10100011011110101111010111101
10101000000000100000010000001
10101010111011111010111110101
10001010001000000010000000101
10111011101111011110111101101
14000000000000p00000000000041
11111111111111111111111111111

0 ball
1 wall
2 gate          (only one)
p pacman        (only one)
g ghost         (only four)
3 blank
4 power ball
